w w w w w w w w w w w w w w w w
w f f f w f f w f s f w f f f w
w f f f w f f w f f f w f f f w
w f f f f f f f f f f f f f f w
w f f f w f f w f f f w w w w w
w f f f w f f w f f f w f f f w
w w w w w f f w f f f w f f f w
w f f f w f f w f f f w f f f w
w f f f w f f w f f f w f f f w
w f f f f f f f f f f f f f f w
w f f f w f f w f f f w w w w w
w f f f w f f w f f f w f f f w
w w w w w f f w f f f w f f f w
w f f f w f f w f f f w f f f w
w f f f w f f w f f f w f f f w
w f e f f f f f f f f f f f f w
w f f f w f f w f f f w f f f w
w f f f w f f w f f f w f f f w
w w w w w w w w w w w w w w w w
