a f f f f f f g
f ? ? ? ? ? ? f
f ? ? ? ? ? ? f
f ? ? ? ? ? ? f
f ? ? ? ? ? ? f
f ? ? ? ? ? ? f
f ? ? ? ? ? ? f
b f f f f f f c
