w w w w w w w w
w f f w s w f w
w f f w f w f w
w f f f f w f w
w f f w f f f w
w f f w f w f w
w e f w f w f w
w w w w w w w w
