s f f w f f f
w w f w f w f
f w f w f w f
f w f w w w f
f w f w f f f
f w f w f w f
e f f f f w f
