s f f w f f e
w w f w f w f
f w f w f w f
f w f w w w f
f w f w f f f
f w f w f w f
f f f f f w f
